10
68
000000000000000000000000000000000000000000000000000000000000000000000
000000000000000000000000000000000000000000000000000000000000000000000
000000000000000000000000000000000000000000000000000000000000000000007
000000000000000000000010010010010010010001000100000100000100000100100
000000000000000000100000000000000000000000000000000000000000000000000
000000000000000010000000000000000000000000000000000000000000000000000
000000000011001100000000000000000000000000000000000000000000000000000
102000010000000000000000000000000000000000000000000000000000000000001
510011000000003000333300000300000300003000300000003300000300003000015
511155111111111111111111111111111111111111111111111111111111111111115