10
68
10000000000000011000011000000000000003000000000000000000000000000001
10000000001100000000000000000000000000000000000000000000000000000001
10000000000000001100000000000000000000000000000000000000000000000001
10200000000000000000001111111110100010000100010000000000000000000001
10000000000000000000000000000000000000000000000001000000000000000001
10000000000000000000000000000000000000000000000000000000000000000001
10000000000000000000000000000000000000000000010000000000000000000001
00000000000000000000000000000000000000000000000000000000000000000001
10000000000000000000000000000000000000000000000010000000000000000001
11111111111111111001111001111111111111111000010000000000000000000001
