10
17
00000000000000000
00000000000000000
00020000000000000
00000000000000000
00000000000000000
00000000000000000
00000000000000000
00000000000000000
00000000000000000
11111111111111111