10
68
10000000000000011000011000110001100011000011000110001100011000000001
10000000001100000000000000000000000000000000000000000000000100066001
10000000000000001100000000000000000000000000000000000000000000046001
10200000000000000000001111111110100010000100010000000000000000666001
10000000000000000000000000000000000000000000000100000000000000000001
10000000000000000000000000000000000000000000000001000000000000000001
10000000000000000000000000000000000000000000000000010001000000000001
00000000000000000000000000000000000000000000000000000000000100000001
10000000000000000000000000000000000000000000100000000000100000000001
11111111111111111001161101161101161101161100000010000100000000000001
