10
68
00000000000000000000000000000000000000000000000000000000000000000000
00000000000000000000000000000000000000000000000000000000000000000000
00000000000000000000000000000000000000000000000000000000000000000000
00000000000000000011100000000000000000000000000000000000000000000000
11140000000000000055511001111111111110001110001100110011100000000000
65511111111111000066555006566666666560000000000000000000000110000000
65666666666666000066666000055555555000000000000000000000000000011111
65000000000000000060006000000060000000000000000000000000000000166666
65200000000000000060006000000360000300000000000000000000000011666666
65555555555555550055555005555555555555555000110011000110011166666666