10
68
00000000000000000000000000000000000000000000000000000000000000000000
00000000000000000000000000000000000000000000000000000000000000000000
00000000000000000000000000000000000000000000000000000000000000000000
00000000000000000000000000000000000000000000000000000000000000000000
00000000000000001100000000000000000000000000000000000000000000000000
00000000000001100000000000000000000000000000000000000000000000000000
10000000011000000000000000000000000000000000000000000000000000000011
10000011000000000000000000000000000000000000000000000000000000000011
12000000000000000000000000000000000000000000000000000000000000000011
11111111111111111111111111111111111111111111111111111111111111111111