10
68
100000000000000000000000000000000010000000000000000000000000000000001
100000000000000000000000000000000011111110000000000000000000000000001
100000000003000000000000000000000010000000001110000000000000000000001
100333000000000000000000000000000010000000000000001100000000000000001
100000000000011110001100011110000010000000000000000000111000000000001
100000300011111110000000011111100010000000000000000000000001100000001
100000111111111100000000001111110010000000000000000000000000000111001
101111111111111000000000000111111110000000000000000000000000001110001
120000000000000000000000000000000000000000000000000000000000111000001
111111111111111110011110011111111111111110000000110000000111110000001