10
34
0000000000000000000000000000000000
0000000000000000000000000000000000
0000000000000000111110000000000000
0000000000000001000000000000000000
0000000000000010000000000000000000
0000000000000100000000000000000000
0000000000001000000000000000000000
0000000000010000000000000000000000
0000000020100000000000000000000000
1111111111111111111111111111111111