10
68
100000000000000000000000000000000000000000000000000000000000000000001
100000000000000000000000000000000000000000000000000000000000000000001
100000000000000000000000000000000000000000000000000000000000000000001
100000000000000000000010010010010010010001000100000100000100000100101
100000000000000000010000000000000000000000000000000000000000000000001
100000000000000010000000000000000000000000000000000000000000000000001
100000000001001000000000000000000000000000000000000000000000000000001
102000010000000000000000000000000000000000000000000000000000000000001
100011030030003000333300000300000300003000300000003300000300003000001
111111111111111111111111111111111111111111111111111111111111111111111