10
10
0000000000
0000000000
0000000000
0000000000
0000000000
0000000000
0000000000
0000000000
1000000001
1111111111