0000000000
0000000000
0000000000
0000000000
0000000000
0000000000
0000200000
1000000001
1111111111