10
68
100000000000000000000000000000000000030000000000000000000000000000001
100000000000000000000000000000000000000000000000000000000000000000001
100000000000000000000000000000000000000000000000000000000000000000001
102000000000000000000000000000000000000000000000000000000000000000001
100000400000000000000000000000000000000000000000000000000000000000000
100000000000000000000000000000000000000000000000000000000000000000001
100000000000000000000000000000000000000000000000000000000000000000001
000000000000000000000000000000000000000000000000000000000000000000001
100000300000000000003000000000030000000000000000000000000000000000001
111111111111111110011110011111111111111110000000110000000111110000001
