10
68
111111111111111111111111111111111111111111111111111111111111111111101
111111111111111111111111111111111111111111111111111111111111111111111
111110000000000000000000000000000000000000000000000000000000000000001
111110000000000000000000000000000000000000000000000000000000000000001
111110000000011110001111011110000010101010101010101010111000000000001
114000000011111000000000011111100010000000000000000000000001100000001
111111111111110000000000001111110010000000000000000000000000000111001
111111111110000000000000000111111110000000000000000000000000001110001
102000300000000000000000000000030003000000000000000000000000111000001
111111111111111100111110011111111111111110001100110001100111110000001