10
68
100000000000000000000000000000000000000000000000000000000000000000001
100000000000000000000000000000000000000000000000000000000000000000001
100000000000000000000000000000000000000000000000000000000000000000001
100000000000000000000000000000000000000000000000000000000000000000001
100000000000000000000000000000000000000000000000000000000000000000001
100000000000000000000000000000000000000000000000000000000000000000001
100000000000000000000000000000000000000000000000000000000000000000001
102000000000000000000000000000000000000000000000000000000000000000001
10000000040000030003333000000000000000000003000000033000000000000001
111111111111111111111111111111111111111111111111111111111111111111111