10
68
100000000000000000000000000000000000030000000000000000000000000000001
100000000000000000000000000000000011111110000000000000000000000000001
100000000000000000000000000000000010000000001110000000000000000000001
102000000000000000000000000000000010000000000000001100000000000000001
100000000000011110001100011110000010000000000000000000111000000000001
104000000011111110000000011111100010000000000000000000000001100000001
100000111111111100000000001111110010000000000000000000000000000111001
111111111111111000000000000111111110000000000000000000000000001110001
100000300000000000003000000000030000000000000000000000000000111000001
111111111111111110011110011111111111111110000000110000000111110000001
10
68
100000000000000000000000000000000000000000000000000000000000000000001
100000000000000000000000000000000000000000000000000000000000000000001
100000000000000000000000000000000000000000000000000000000000000000001
100000000000000000000000000000000000000000000000000000000000000000001
100000000000000000000000000000000000000000000000000000000000000000001
100000000000000000000000000000000000000000000000000000000000000000001
100000000000000000000000000000000000000000000000000000000000000000001
100000000000000000000000000000000000000000000000000000000000000000001
120000000000333333333333333333333333333333333333333333000000000000001
111111111111111111111111111111111111111111111111111111111111111111111