10
68
000000000000000000000000000000000000000000000000000000000000000000000
000000000000000000000000000000000000000000000000000000000000000000000
000000000000000000000000000000000000000000000000000000000000000000070
000000000000000000000010010010010010010001000100000100000100000100100
000000000000000000100000000000000000000000000000000000000000000000000
000000000000000010000000000000000000000000000000000000000000000000000
000000000011001100000000000000000000000000000000000000000000000000000
002000010000000000000000000000000000000000000000000000000000000000000
100011333333333333333333333333333333333333333333333333333333333333331
511155111111111111111111111111111111111111111111111111111111111111115