10
68
111110000000000000000000000000000000000000000000000000000000000000000
111110000000000000000000000000000000000000000000000000000000000000000
111110000000000000000000000000000000000000000000000000000000000000001
111110000000000000011000000000000000000000000000000000000000000000001
111110000000000000011111011111111111100011100011001100111000000000001
114003000011111000000000001111111111000000000000000000000001100000001
111111111111100000000000000111111110000000000000000000000000000111001
111111111100000000000000000000100000000000000000000000000000001110001
102000000000000000000000000003000003000000000000000000000000111000001
111111111111111100111110011111111111111110001100110001100111110000001