10
68
00000000000000001111100000000000000000000000000000000000000000000000
00000000000000011111100000000000000000000000000000000000000000000000
00000000000000111111100000000000000000000000000000000000000000000000
00000000000001111111100000000000000000000000000000000000000000000000
00000000000011111111100000000000000000000000000000000000000000000000
00000000000111111111100000000000000000000000000000000000000000000000
10000000001111111111100000000000000000000000000000000000000000000000
10000000011111111111100000000000000000000000000000000000000000000000
12000001111111111111000000000000000000000000000000000000000000000000
11111111111111111111111111111111111111111111111111111111111111111111