10
68
00000000000000000000000000000000000000000000000000000000000000000000
00000000000000000000000000000000000000000000000000000000000000000000
00000000000000000000000000000000000000000000000000000000000000000000
00000000000000000011100000000000000000000000000000000000000000000000
11140000000000000056611001111111111110001110001100110011100000000000
65511111111111100005650000566666666500000600006600660006000110000000
65555555555555000000500000055555555000000000000000000000000000011111
65000000000000000000000000000000000000000000000000000000000000166666
65200000000000000000000000000300000300000000000000000000000011666666
65555555555555550055555005555555555555555000110011000110011166666666